furywarrior	MazonAddon/Combat/WarriorFury.lua
protwarrior	MazonAddon/Combat/WarriorProt.lua
armswarrior	MazonAddon/Combat/WarriorArms.lua
bmhunter	MazonAddon/Combat/HunterBM.lua
mmhunter	MazonAddon/Combat/HunterMM.lua
eleshaman	MazonAddon/Combat/ShamanEle.lua
restoshaman	MazonAddon/Combat/ShamanResto.lua
bmmonk	MazonAddon/Combat/MonkBrewmaster.lua
mwmonk	MazonAddon/Combat/MonkMistweaver.lua
blooddk	MazonAddon/Combat/DKBlood.lua
unholydk	MazonAddon/Combat/DKUnholy.lua
pvpdk	MazonAddon/Combat/DKPvp.lua
restodruid	MazonAddon/Combat/DruidResto.lua
mmhunterfollower	MazonAddon/Combat/HunterMMFollower.lua
mwmonkfollower	MazonAddon/Combat/MonkMistweaverFollower.lua
eleshamanfollower	MazonAddon/Combat/ShamanEleFollower.lua
bmhunterfollower	MazonAddon/Combat/HunterBMFollower.lua
classicwarrior	MazonAddon/Combat/WarriorClassic.lua
classictank	MazonAddon/Combat/WarriorClassicTank.lua
classicshaman	MazonAddon/Combat/ShamanClassic.lua
classicdruid	MazonAddon/Combat/DruidClassic.lua
classicdruidfollower	MazonAddon/Combat/ClassicDruidFollower.lua
classichunterfollower	MazonAddon/Combat/ClassicHunterFollower.lua
classichunter	MazonAddon/Combat/ClassicHunterRunner.lua
classicferal	MazonAddon/Combat/ClassicFeral.lua